NO ./textures/kawaii/path_to_the_north_texture.xpm
SO ./textures/kawaii/path_to_the_south_texture.xpm
WE ./textures/kawaii/path_to_the_west_texture.xpm
EA ./textures/kawaii/path_to_the_east_texture.xpm
F 80,80,80
C 180,180,240



111111111111111111111111111111
100000000000000000000000000001
101111111111101111111111111101
101000000001001000000000000101
101011111101111111111101110101
101010000100000000001000010101
101010111101111111101111010101
101010100001000001000100010101
101010111101011111101111110101
101000000101000000101000000101
101111110101111110101111110101
100000010100000010100000010001
111110010111111010111110010111
100010010000001010000010010001
101110111111101111101111111101
100000000001000000000000000001
101111111101011111111111111101
1000000000010000000000000000N1
111111111111111111111111111111

