NO ./textures/kawaii/Sanrio_1.xpm
SO ./textures/kawaii/Sanrio_2.xpm
WE ./textures/kawaii/Sanrio_3.xpm
EA ./textures/kawaii/Sanrio_4.xpm

F 60,60,60
C 220,220,255



111111111111111111111111111111
100000000000000001000000000001
101111111011111101011111110101
100000001010000001010000010001
111110101011111101011111110111
100010101000000101000000000001
101110111011111111011111111101
100000100010000000010000000001
101111111110111111111111111101
100000000000100000000000000001
101111111111101111111111110101
101000000000001000000000010101
101011111111111011111110010101
101000000000001000000010010001
101011111111101111111010111101
100010000000001000000010000001
111110011111101111111110111101
1000001000000000000000000000S1
111111111111111111111111111111

