NO ./textures/bb/fibi_64x64.xpm
SO ./textures/bb/fi_linus_64.xpm
WE ./textures/bb/mimikai.xpm
EA ./textures/bb/mimidown.xpm

F 1, 90, 3
C -1,0,120

	111111111111111111111111111					
111110000001100000000000111111
10110000011100000N0000000111111
1001000000000000000000111111111
1111111110110000011010001
1000000011000001111111001
1111111111111101110000001
1111111111111101110101001   
1100000110101011100000001
1000000001100000000000001
1000000000100000110101001
1100000111011111111101101
111101110111010111111111
11 1111111111111111  				
