NO ./texture/test1.xpm
SO ./texture/test2.xpm
WE ./texture/test3.xpm
EA ./texture/test4.xpm

F 220,0,10
C 225,30,0

111111111 11111111111111
111110011 1100000000000111111
1011000111100000S0000000111111
100100011000000000000111111
111111111111111101110001
1000000000110000011111111
1111011111111101110000001
1111111111111101110101001
1100000110101011100000011
100000000000000000000011
1000000000000000110101001
1000000111011111111101111
111011101 1 101111111111
11111111111 1111111111