NO ./texture/test1.xpm
SO ./texture/test2.xpm
WE ./texture/test3.xpm
EA ./texture/test4.xpm

F 220,0,10
C 225,30,0

	1111111111111111111111111
111110000001100000000000111111
10110000011100000S0000000111111111
10010000000000000000000111111
1111111110110000011100001
1000000000110000011111111
1111011111111101110000001
1111111111111101110101001
110000011010101110000001
100000000000000000000001
1000000000000000110101001
1100000111011111111101111
1111011101110101111111101
11 1111111111111111  1111
