NO ./texture/test1.xpm
EA ./texture/test4.xpm
SO ./texture/test2.xpm
WE ./texture/test3.xpm
   
C 225,30,0
F 220,0,10


		1111111111111111111111111
		1000000000110000000000001
		1011000001110000111000001
		10010000000000001 1000001
111111111011000001110000111000001
100000000011000001110111111111111
11110111111111011100000010001
11110111111111011101010010001
11000000110101011100000010001
10000000000000000011000000101
10000000000000001101010010001
11000001110101011111011110N0111
11110111 1110101 101111010001
11111111 1111111 111111111111
