NO ./textures/divers/factorylargerocksplain.xpm
SO ./textures/divers/bookshelf_1_.xpm
WE ./textures/divers/invalid_xpm.xpm 
EA ./textures/divers/bark.xpm

F 50,50,50




C 200,200,255



1111111111111111111111111
1000000000111110000000001
1011111100100010111111101
10100001000000S0000000101
1010111100111110111110101
1010000000000010000010101
1011111011111010111010101
1000001010000010100010101
1111101010111110101110111
1000100010100000100000101
1011101110101111101111101
1010000000101000000000001
1010111111101011111111101
1000000000001010000000001
1111111111111111111111111

